13tv=13 Ulica
AMC=AMC FULL HD
AnimalPlanet=Animal Planet
AnimalPlanet=Animal Planet HD
Arena Sport 1=Arena Sport 1 HD
Arena Sport 2=Arena Sport 2 HD
Auto Motor Sport=Auto Motor und Sport Channel
AXN=AXN
AXN Black=AXN Black
AXN White=AXN White
Babes TV=Babes TV HD
Baby TV=BaBy TV
BBC World News=BBC Earth
Brazzers TV Europe=Brazzers FULL HD
13tv=Bundesliga 3
Canal+ Series HD=Canal+ Seriale
Cartoon Network=Cartoon Network FULL HD
Cinemax=Cinemax 2 FULL HD
Cinemax 2=Cinemax FULL HD
CNN International=CNN
CNN Prima News=CNN Prima News FULL HD
Comedy Central=Comedy Central
Crime and Investigation=Crime+Investigation Polsat
CS Film=CS Film HD
CS Horror=CS Horror
CS Mystery=CS Mystery
ČT :D=ČT D HD ČT art FULL HD
ČT4 Sport=ČT Sport HD
ČT1=ČT1 FULL HD
ČT2=ČT2 FULL HD
ČT24=ČT24 FULL HD
ČT3=ČT3 FULL HD
TV DAJTO=Dajto FULL HD
Discovery=Discovery HD
Discovery=Discovery Channel
Discovery Science=Discovery Science
Discovery Science=Discovery Science FULL HD
Disney Channel=Disney Channel
Disney Junior=Disney Junior
Disney Junior=Disney Junior
DocuBox HD=DocuBox HD
Doma=Doma FULL HD
Dorcel TV=Dorcel TV HD
Dorcel XXX=Dorcel XXX HD
STV2=Dvojka FULL HD
Erox HD=Erox FULL HD
Eroxxx HD=Eroxxx FULL HD
Eska TV=ESKA TV
Eurosport 1=Eurosport 1 HD
Eurosport 2=Eurosport 2 HD
Extasy 4K=Extasy 4K FULL HD
Extasy=Extasy HD
Extreme Sports=Extreme Sports Channel
Fast&Funbox HD=Fastnfunbox HD
FightBox=Fightbox HD
Filmbox Stars=Film Box Stars
Film Europe +=Film Europe + FULL HD
Film Europe=Film Europe FULL HD
Film+=Film+ FULL HD
Filmbox Extra HD=Filmbox Extra FULL HD
Filmbox Family=Filmbox Family
Filmbox Family=Filmbox FULL HD
Filmbox Premium=Filmbox Premium FULL HD
Fokus TV=Fokus TV
FOX=FOX
Gold TV=Goldstar TV
Golf Channel=Golf Channel HD
HBO=HBO FULL HD
HBO2=HBO2 FULL HD
HBO3=HBO3 FULL HD
HGTV=HGTV
History Channel=History Channel FULL HD
Chuck TV=Chucktv FULL HD
Investigation Discovery=Investigation Discovery HD
STV1=Jednotka FULL HD
Jim Jam=JimJam
JOJ +1=JoJ +1 HD
JOJ Cinema +1=JoJ Cinema +1 FULL HD
JOJ Cinema=JOJ Cinema FULL HD
JOJ Family=JoJ Family FULL HD
JOJ=JoJ FULL HD
JOJ Plus=JoJ Plus FULL HD
JOJ Šport=JoJ Šport HD
Jojko=Jojko HD
Kino Barrandov=Kino Barrandov FULL HD
Kino TV=Kino TV
Barrandov Krimi=Krimi Barrandov FULL HD
Lala TV=LALA TV HD
Leo TV Gold=Leo Gold HD
Leo=Leo TV FULL HD
Love Nature=Love Nature FULL HD
Markíza +1=Markíza +1 FULL HD
Markíza=Markiza FULL HD
Markíza International=Markíza International FULL HD
Mezzo=Mezzo HD
Minimax=Minimax
Mini TV=MiniMini+
MTV=MTV
MTV00s=MTV 00s
MTV80s=MTV 80s
MTV90s=MTV Hits
MTV Polska=MTV Polska
NASA TV=NASA TV
NASA TV UHD=NASA TV UHD
National Geographic Wild HD Europe=Nat Geo WILD FULL HD
National Geographic HD=National Geographic FULL HD
National Geographic Wild HD Europe=National Geographic Wild
Nick Jr.=Nick Jr.
Nickelodeon=Nickelodeon
Nicktoons=Nicktoons
Nova Action=Nova Action FULL HD
Nova Cinema=Nova Cinema FULL HD
Nova=Nova FULL HD
Nova Fun=Nova Fun FULL HD
Nova Gold=Nova Gold FULL HD
Nova International=Nova International FULL HD
Nova Lady=Nova Lady FULL HD
Nova Sport 1=Nova Sport 1 HD
Nova Sport 2=Nova Sport 2 HD
Nova Sport 3=Nova Šport 3 FULL HD
Nova Sport 4=Nova Šport 4 FULL HD
O2TV Fotbal=O2TV Fotbal FULL HD
O2TV Sport5=O2TV Sport 5
O2TV Sport6=O2TV Sport 6
O2TV Fotbal=O2TV Sport FULL HD
O2TV Sport6=O2TV Tenis FULL HD
Óčko Expres=Óčko Expres HD
Óčko=Óčko HD
Óčko Star=Óčko Star HD
Paramount Network=Paramount Netvork FULL HD
Playboy TV=Playboy TV HD
Polo TV=Polo TV
Premier Sport 1=Premier Sports 1 HD
Premier Sport 2=Premier Sports 2 HD
Prima Cool=Prima COOL FULL HD
Prima=Prima FULL HD
Prima Krimi=Prima Krimi FULL HD
Prima LOVE=Prima Love FULL HD
Prima MAX=Prima MAX FULL HD
Prima Show=Prima Show HD
Prima Star=Prima Star HD
Prima ZOOM=Prima ZOOM FULL HD
Private TV=Private TV HD
Reality Kings TV=Reality Kings
Rebel=Rebel
RELAX=RELAX
Retro Music=Retro Music TV
Retro Music=Retro Music TV
Rik TV=Rik HD
Spektrum=Spektrum HD
Sport 5=Sport 5
Sport1=Sport1 HD
Sport2=Sport2 HD
Šlágr Premium=Šlágr Premium HD
Sláger TV=Šlágr TV
TA3=TA3 HD
TLC=TLC
TNT-Comedy=TNT
Travel Channel=Travel Channel HD
Travelxp HD=Travel XP
Trojka=Trojka FULL HD
True Amateurs=True Amateurs HD
TTV=TTV
Barrandov=TV Barrandov FULL HD
TV Natura=TV Natura HD
Paprika=Tv Paprika
Viasat Explorer=Viasat Explore FULL HD
Viasat History=Viasat History FULL HD
Viasat Nature=Viasat Nature FULL HD
WAU=WAU FULL HD